"a" = (/turf/template_noop,/area/template_noop)
"b" = (/obj/effect/fluid_mapped,/turf/simulated/floor/beach/sand,/area/map_template/aquarium)
"c" = (/obj/effect/wallframe_spawn/reinforced,/turf/simulated/floor/plating,/area/map_template/aquarium)
"d" = (/obj/machinery/power/port_gen/pacman/super,/obj/structure/cable{icon_state = "0-4"; d2 = 4},/turf/simulated/floor/plating,/area/map_template/aquarium)
"e" = (/obj/machinery/power/terminal{dir = 4},/obj/structure/cable{d2 = 8; icon_state = "0-8"},/turf/simulated/floor/plating,/area/map_template/aquarium)
"f" = (/obj/structure/cable{icon_state = "0-4"; d2 = 4},/obj/machinery/power/smes/buildable/max_cap_in_out,/turf/simulated/floor/plating,/area/map_template/aquarium)
"g" = (/obj/machinery/power/apc{dir = 1},/obj/structure/cable{d2 = 8; icon_state = "0-8"},/turf/simulated/floor/plating,/area/map_template/aquarium)
"h" = (/obj/machinery/light/small{icon_state = "bulb1"; dir = 4},/turf/simulated/floor/plating,/area/map_template/aquarium)
"i" = (/obj/machinery/portable_atmospherics/powered/pump,/turf/simulated/floor/plating,/area/map_template/aquarium)
"j" = (/obj/structure/closet/crate/uranium,/turf/simulated/floor/plating,/area/map_template/aquarium)
"k" = (/obj/machinery/suit_cycler/medical/alt{locked = 0},/turf/simulated/floor/plating,/area/map_template/aquarium)
"l" = (/turf/simulated/floor/plating,/area/map_template/aquarium)
"m" = (/obj/machinery/portable_atmospherics/canister/air,/turf/simulated/floor/plating,/area/map_template/aquarium)
"n" = (/obj/machinery/door/airlock,/turf/simulated/floor/plating,/area/map_template/aquarium)
"o" = (/obj/machinery/portable_atmospherics/canister/oxygen,/turf/simulated/floor/plating,/area/map_template/aquarium)
"p" = (/obj/structure/table/rack,/obj/item/clothing/suit/space/void/medical/alt,/obj/item/clothing/head/helmet/space/void/medical/alt,/obj/item/weapon/tank/oxygen/red,/obj/item/weapon/storage/firstaid/o2,/turf/simulated/floor/plating,/area/map_template/aquarium)
"q" = (/turf/simulated/floor/tiled/white,/area/map_template/aquarium)
"r" = (/obj/effect/wallframe_spawn/reinforced,/obj/effect/floor_decal/beach{icon_state = "beachborder"; dir = 8},/turf/simulated/floor/plating,/area/map_template/aquarium)
"s" = (/obj/effect/fluid_mapped,/obj/random/medical/lite,/turf/simulated/floor/beach/sand,/area/map_template/aquarium)
"t" = (/obj/effect/fluid_mapped,/obj/machinery/light{icon_state = "tube1"; dir = 1},/turf/simulated/floor/beach/sand,/area/map_template/aquarium)
"u" = (/obj/effect/fluid_mapped,/mob/living/simple_animal/aquatic/fish,/turf/simulated/floor/beach/sand,/area/map_template/aquarium)
"v" = (/obj/effect/wallframe_spawn/reinforced,/obj/effect/floor_decal/beach{icon_state = "beachborder"; dir = 4},/turf/simulated/floor/plating,/area/map_template/aquarium)
"w" = (/obj/structure/drain,/turf/simulated/floor/plating,/area/map_template/aquarium)
"x" = (/obj/effect/fluid_mapped,/obj/effect/landmark/corpse/doctor,/turf/simulated/floor/beach/sand,/area/map_template/aquarium)
"y" = (/obj/effect/fluid_mapped,/mob/living/simple_animal/aquatic/fish/grump,/turf/simulated/floor/beach/sand,/area/map_template/aquarium)
"z" = (/obj/machinery/light{dir = 1},/obj/machinery/vending/medical,/turf/simulated/floor/tiled/white,/area/map_template/aquarium)
"A" = (/obj/machinery/vending/coffee{name = "hacked Hot Drinks machine"; prices = list()},/turf/simulated/floor/tiled/white,/area/map_template/aquarium)
"B" = (/obj/machinery/door/airlock,/obj/effect/floor_decal/beach{icon_state = "beachborder"; dir = 4},/turf/simulated/floor/plating,/area/map_template/aquarium)
"C" = (/obj/machinery/light{icon_state = "tube1"; dir = 8},/turf/simulated/floor/tiled/white,/area/map_template/aquarium)
"D" = (/obj/structure/table/standard{name = "plastic table frame"},/obj/machinery/reagentgrinder,/turf/simulated/floor/tiled/white,/area/map_template/aquarium)
"E" = (/obj/effect/fluid_mapped,/mob/living/simple_animal/aquatic/fish/judge,/turf/simulated/floor/beach/sand,/area/map_template/aquarium)
"F" = (/obj/effect/wallframe_spawn/reinforced,/obj/effect/floor_decal/beach,/obj/effect/floor_decal/beach{icon_state = "beachborder"; dir = 4},/turf/simulated/floor/plating,/area/map_template/aquarium)
"G" = (/obj/effect/wallframe_spawn/reinforced,/obj/effect/floor_decal/beach,/turf/simulated/floor/plating,/area/map_template/aquarium)
"H" = (/obj/effect/wallframe_spawn/reinforced,/obj/effect/floor_decal/beach/corner{icon_state = "beachbordercorner"; dir = 1},/turf/simulated/floor/plating,/area/map_template/aquarium)
"I" = (/obj/structure/closet/walllocker/emerglocker/east,/turf/simulated/floor/tiled/white,/area/map_template/aquarium)
"J" = (/obj/machinery/light{dir = 4; icon_state = "tube1"},/turf/simulated/floor/tiled/white,/area/map_template/aquarium)
"K" = (/obj/structure/table/standard{name = "plastic table frame"},/obj/random/medical/lite,/turf/simulated/floor/tiled/white,/area/map_template/aquarium)
"L" = (/obj/effect/wallframe_spawn/reinforced,/obj/effect/floor_decal/beach/corner{icon_state = "beachbordercorner"; dir = 4},/turf/simulated/floor/plating,/area/map_template/aquarium)
"M" = (/obj/machinery/door/airlock,/turf/simulated/floor/tiled/white,/area/map_template/aquarium)
"N" = (/obj/structure/table/standard{name = "plastic table frame"},/obj/item/weapon/storage/firstaid/surgery,/turf/simulated/floor/tiled/white,/area/map_template/aquarium)
"O" = (/obj/machinery/light,/turf/simulated/floor/tiled/white,/area/map_template/aquarium)
"P" = (/obj/structure/table/standard{name = "plastic table frame"},/obj/machinery/light,/obj/random/loot,/turf/simulated/floor/tiled/white,/area/map_template/aquarium)
"Q" = (/obj/structure/table/standard{name = "plastic table frame"},/obj/random/loot,/obj/random/medical/lite,/turf/simulated/floor/tiled/white,/area/map_template/aquarium)
"R" = (/obj/machinery/light,/obj/structure/table/standard{name = "plastic table frame"},/obj/random/firstaid,/turf/simulated/floor/tiled/white,/area/map_template/aquarium)
"S" = (/obj/structure/table/standard{name = "plastic table frame"},/obj/random/masks,/turf/simulated/floor/tiled/white,/area/map_template/aquarium)
"T" = (/obj/effect/paint_stripe/blue,/turf/simulated/wall,/area/map_template/aquarium)

(1,1,1) = {"
aTTcTTTTTTTcTTa
aTdefghTijklmTa
aTlllllnlllloTa
TTTTTTTTTnTlpTa
TqrbstubvwTnTTT
TqrbuxbyvnTqzAT
TqrbbysbBhTqqqc
TCrbbbbuvcTqDqc
TqrbEFGGHITqqqc
TqrbbvqqqJTqKqc
TqLGGHqqqqMqNqc
TqqqqqqqqqcqOqT
TqPKQRSTnTTTTTT
TTTTTTTTlTaaaaa
aaaaaaaTnTaaaaa
"}
