"a" = (/turf/template_noop,/area/template_noop)
"b" = (/turf/simulated/wall,/area/template_noop)
"c" = (/obj/structure/mattress/dirty,/obj/effect/landmark/corpse/chef,/obj/effect/decal/cleanable/blood,/turf/simulated/floor/plating,/area/template_noop)
"d" = (/obj/structure/closet/crate/freezer{name = "emergency rations"},/obj/item/stack/animalhide/human,/obj/random/loot,/turf/simulated/floor/plating,/area/template_noop)
"e" = (/obj/effect/decal/cleanable/blood/drip,/obj/effect/decal/cleanable/dirt,/turf/simulated/floor/plating,/area/template_noop)
"f" = (/obj/structure/reagent_dispensers/watertank,/turf/simulated/floor/plating,/area/template_noop)
"g" = (/obj/random/junk,/turf/simulated/floor/plating,/area/template_noop)
"h" = (/obj/structure/kitchenspike,/obj/effect/decal/cleanable/cobweb,/turf/simulated/floor/tiled/freezer,/area/template_noop)
"i" = (/obj/structure/kitchenspike,/obj/effect/decal/cleanable/blood/gibs/up,/turf/simulated/floor/tiled/freezer,/area/template_noop)
"j" = (/obj/structure/kitchenspike,/obj/item/stack/animalhide/human,/obj/effect/decal/cleanable/blood/gibs,/turf/simulated/floor/tiled/freezer,/area/template_noop)
"k" = (/obj/effect/decal/cleanable/blood/drip,/obj/effect/decal/cleanable/dirt,/obj/effect/decal/cleanable/mucus,/turf/simulated/floor/plating,/area/template_noop)
"l" = (/obj/effect/decal/cleanable/vomit,/turf/simulated/floor/plating,/area/template_noop)
"m" = (/obj/random/trash,/turf/simulated/floor/plating,/area/template_noop)
"n" = (/obj/effect/decal/cleanable/dirt,/obj/effect/decal/cleanable/spiderling_remains,/turf/simulated/floor/plating,/area/template_noop)
"o" = (/obj/structure/closet/crate/freezer{name = "emergency rations"},/obj/item/organ/internal/appendix,/obj/item/weapon/reagent_containers/food/snacks/meat/human,/obj/item/weapon/reagent_containers/food/snacks/meat/human,/obj/effect/decal/cleanable/dirt,/turf/simulated/floor/plating,/area/template_noop)
"p" = (/obj/effect/decal/cleanable/blood/gibs/body,/turf/simulated/floor/tiled/freezer,/area/template_noop)
"q" = (/obj/effect/landmark/corpse/engineer,/obj/effect/decal/cleanable/blood/gibs,/obj/effect/decal/cleanable/dirt,/turf/simulated/floor/tiled/freezer,/area/template_noop)
"r" = (/obj/item/weapon/reagent_containers/food/snacks/meat/human,/obj/effect/decal/cleanable/blood/gibs,/turf/simulated/floor/tiled/freezer,/area/template_noop)
"s" = (/turf/simulated/floor/plating,/area/template_noop)
"t" = (/obj/effect/decal/cleanable/blood/drip,/obj/effect/decal/cleanable/dirt,/obj/effect/decal/cleanable/generic,/turf/simulated/floor/tiled,/area/template_noop)
"u" = (/obj/effect/decal/cleanable/dirt,/obj/effect/decal/cleanable/molten_item,/turf/simulated/floor/tiled,/area/template_noop)
"v" = (/obj/effect/decal/cleanable/blood/drip,/obj/effect/decal/cleanable/dirt,/obj/random/junk,/turf/simulated/floor/plating,/area/template_noop)
"w" = (/obj/effect/decal/cleanable/dirt,/turf/simulated/floor/plating,/area/template_noop)
"x" = (/obj/structure/closet/crate/freezer{name = "emergency rations"},/obj/random/loot,/obj/effect/decal/cleanable/blood/gibs/limb,/obj/effect/decal/cleanable/dirt,/turf/simulated/floor/tiled/freezer,/area/template_noop)
"y" = (/obj/effect/decal/cleanable/blood/gibs,/obj/effect/decal/cleanable/blood,/obj/effect/decal/cleanable/dirt,/turf/simulated/floor/tiled/freezer,/area/template_noop)
"z" = (/obj/effect/decal/cleanable/blood/gibs/core,/obj/effect/decal/cleanable/dirt,/obj/effect/decal/remains,/turf/simulated/floor/tiled/freezer,/area/template_noop)
"A" = (/obj/structure/closet/crate/freezer{name = "emergency rations"},/obj/item/organ/internal/heart,/obj/item/weapon/reagent_containers/food/snacks/meat/human,/turf/simulated/floor/tiled,/area/template_noop)
"B" = (/obj/effect/decal/cleanable/dirt,/turf/simulated/floor/tiled,/area/template_noop)
"C" = (/obj/machinery/floodlight,/obj/effect/decal/cleanable/dirt,/turf/simulated/floor/tiled,/area/template_noop)
"D" = (/obj/item/weapon/reagent_containers/food/snacks/meat/human,/obj/effect/decal/cleanable/blood/gibs/robot,/obj/effect/decal/cleanable/blood/gibs,/obj/effect/decal/cleanable/dirt,/turf/simulated/floor/tiled/freezer,/area/template_noop)
"E" = (/obj/effect/decal/cleanable/blood/gibs/down,/obj/effect/decal/cleanable/dirt,/obj/effect/decal/remains,/turf/simulated/floor/tiled/freezer,/area/template_noop)
"F" = (/obj/structure/closet/crate/freezer{name = "emergency rations"},/obj/effect/decal/cleanable/blood/gibs,/obj/random/trash,/obj/random/trash,/turf/simulated/floor/tiled/freezer,/area/template_noop)
"G" = (/obj/machinery/door/airlock,/turf/simulated/floor/tiled,/area/template_noop)
"H" = (/obj/machinery/door/airlock,/turf/simulated/floor/plating,/area/template_noop)
"I" = (/obj/structure/closet/secure_closet/freezer/fridge,/obj/effect/landmark/corpse/doctor,/obj/effect/decal/cleanable/dirt,/turf/simulated/floor/tiled/freezer,/area/template_noop)
"J" = (/obj/effect/decal/cleanable/blood/gibs/limb,/obj/effect/decal/cleanable/dirt,/turf/simulated/floor/tiled/freezer,/area/template_noop)
"K" = (/obj/effect/decal/cleanable/blood/gibs,/obj/effect/decal/cleanable/blood,/turf/simulated/floor/tiled/freezer,/area/template_noop)
"L" = (/obj/effect/floor_decal/spline/plain/white{icon_state = "spline_plain"; dir = 8},/obj/machinery/door/airlock,/obj/effect/decal/cleanable/blood,/turf/simulated/floor/tiled,/area/template_noop)
"M" = (/obj/effect/decal/cleanable/blood/splatter,/obj/effect/decal/cleanable/dirt,/obj/random/trash,/turf/simulated/floor/tiled,/area/template_noop)
"N" = (/obj/effect/decal/cleanable/generic,/obj/effect/decal/cleanable/cobweb2,/turf/simulated/floor/tiled,/area/template_noop)
"O" = (/obj/structure/closet/crate/freezer{name = "emergency rations"},/obj/random/trash,/obj/random/trash,/obj/random/trash,/turf/simulated/floor/tiled,/area/template_noop)
"P" = (/obj/effect/decal/cleanable/generic,/turf/simulated/floor/tiled,/area/template_noop)
"Q" = (/obj/effect/decal/cleanable/blood/splatter,/obj/effect/decal/cleanable/dirt,/turf/simulated/floor/plating,/area/template_noop)
"R" = (/obj/effect/decal/cleanable/dirt,/obj/random/trash,/turf/simulated/floor/plating,/area/template_noop)
"S" = (/obj/effect/decal/cleanable/blood/drip,/obj/effect/decal/cleanable/dirt,/turf/simulated/floor/tiled,/area/template_noop)
"T" = (/obj/structure/pit/closed/grave,/turf/template_noop,/area/template_noop)
"U" = (/obj/structure/closet/coffin,/turf/template_noop,/area/template_noop)
"V" = (/obj/machinery/door/airlock,/obj/effect/decal/cleanable/dirt,/turf/simulated/floor/plating,/area/template_noop)
"W" = (/obj/structure/pit,/turf/template_noop,/area/template_noop)
"X" = (/obj/item/stack/material/wood/ten,/turf/template_noop,/area/template_noop)

(1,1,1) = {"
aaaabbbbbbbb
bbbbbcdebfgb
bhijbklmbnob
bpqrbstubvwb
bxyzbABCbwnb
bDEFbbGbbHbb
bIJKLBMwwBNb
bbbbbOBPQRSb
aTUabbbbbbVb
aaaWXaWaabeb
TaWaaaaXTbHb
"}
