"a" = (/turf/template_noop,/area/template_noop)
"b" = (/obj/effect/paint_stripe/red,/turf/simulated/wall,/area/map_template/aquarium/deadly)
"c" = (/obj/effect/wallframe_spawn/reinforced,/turf/simulated/floor/plating,/area/map_template/aquarium/deadly)
"d" = (/obj/machinery/power/port_gen/pacman/super,/obj/structure/cable{icon_state = "0-4"; d2 = 4},/turf/simulated/floor/plating,/area/map_template/aquarium/deadly)
"e" = (/obj/machinery/power/terminal{dir = 4},/obj/structure/cable{d2 = 8; icon_state = "0-8"},/turf/simulated/floor/plating,/area/map_template/aquarium/deadly)
"f" = (/obj/structure/cable{icon_state = "0-4"; d2 = 4},/obj/machinery/power/smes/buildable/max_cap_in_out,/turf/simulated/floor/plating,/area/map_template/aquarium/deadly)
"g" = (/obj/machinery/power/apc{dir = 1},/obj/structure/cable{d2 = 8; icon_state = "0-8"},/obj/random/tool,/turf/simulated/floor/plating,/area/map_template/aquarium/deadly)
"h" = (/obj/machinery/light/small{icon_state = "bulb1"; dir = 4},/turf/simulated/floor/plating,/area/map_template/aquarium/deadly)
"i" = (/obj/machinery/portable_atmospherics/powered/pump,/turf/simulated/floor/plating,/area/map_template/aquarium/deadly)
"j" = (/obj/structure/closet/crate/uranium,/turf/simulated/floor/plating,/area/map_template/aquarium/deadly)
"k" = (/obj/machinery/suit_cycler/medical/alt{locked = 0},/turf/simulated/floor/plating,/area/map_template/aquarium/deadly)
"l" = (/turf/simulated/floor/plating,/area/map_template/aquarium/deadly)
"m" = (/obj/machinery/portable_atmospherics/canister/air,/turf/simulated/floor/plating,/area/map_template/aquarium/deadly)
"n" = (/obj/machinery/door/airlock,/turf/simulated/floor/plating,/area/map_template/aquarium/deadly)
"o" = (/obj/machinery/portable_atmospherics/canister/oxygen,/turf/simulated/floor/plating,/area/map_template/aquarium/deadly)
"p" = (/obj/structure/table/rack,/obj/item/clothing/suit/space/void/medical/alt,/obj/item/clothing/head/helmet/space/void/medical/alt,/obj/item/weapon/tank/oxygen/red,/turf/simulated/floor/plating,/area/map_template/aquarium/deadly)
"q" = (/turf/simulated/floor/tiled/white,/area/map_template/aquarium/deadly)
"r" = (/obj/effect/fluid_mapped,/turf/simulated/floor/beach/sand,/area/map_template/aquarium/deadly)
"s" = (/obj/effect/fluid_mapped,/obj/random/loot,/turf/simulated/floor/beach/sand,/area/map_template/aquarium/deadly)
"t" = (/obj/structure/drain,/turf/simulated/floor/plating,/area/map_template/aquarium/deadly)
"u" = (/obj/effect/fluid_mapped,/obj/random/medical,/turf/simulated/floor/beach/sand,/area/map_template/aquarium/deadly)
"v" = (/obj/effect/fluid_mapped,/obj/random/contraband,/turf/simulated/floor/beach/sand,/area/map_template/aquarium/deadly)
"w" = (/obj/machinery/light{dir = 1},/obj/machinery/vending/medical,/turf/simulated/floor/tiled/white,/area/map_template/aquarium/deadly)
"x" = (/obj/machinery/vending/coffee{name = "hacked Hot Drinks machine"; prices = list()},/turf/simulated/floor/tiled/white,/area/map_template/aquarium/deadly)
"y" = (/obj/machinery/door/airlock,/obj/effect/floor_decal/beach{icon_state = "beachborder"; dir = 4},/turf/simulated/floor/plating,/area/map_template/aquarium/deadly)
"z" = (/obj/effect/wallframe_spawn/reinforced,/obj/effect/floor_decal/beach,/obj/effect/floor_decal/beach{icon_state = "beachborder"; dir = 4},/obj/effect/fluid_mapped,/turf/simulated/floor/plating,/area/map_template/aquarium/deadly)
"A" = (/obj/effect/wallframe_spawn/reinforced,/obj/effect/fluid_mapped,/turf/simulated/floor/plating,/area/map_template/aquarium/deadly)
"B" = (/obj/structure/table/standard{name = "plastic table frame"},/obj/machinery/reagentgrinder,/turf/simulated/floor/tiled/white,/area/map_template/aquarium/deadly)
"C" = (/obj/effect/fluid_mapped,/obj/machinery/light{icon_state = "tube1"; dir = 8},/turf/simulated/floor/plating,/area/map_template/aquarium/deadly)
"D" = (/obj/effect/fluid_mapped,/turf/simulated/floor/plating,/area/map_template/aquarium/deadly)
"E" = (/obj/effect/fluid_mapped,/obj/machinery/light{dir = 4; icon_state = "tube1"},/turf/simulated/floor/plating,/area/map_template/aquarium/deadly)
"F" = (/obj/structure/closet/walllocker/emerglocker/east,/turf/simulated/floor/tiled/white,/area/map_template/aquarium/deadly)
"G" = (/obj/effect/wallframe_spawn/reinforced,/obj/effect/floor_decal/beach,/turf/simulated/floor/plating,/area/map_template/aquarium/deadly)
"H" = (/obj/effect/wallframe_spawn/reinforced,/obj/effect/floor_decal/beach/corner{icon_state = "beachbordercorner"; dir = 1},/turf/simulated/floor/plating,/area/map_template/aquarium/deadly)
"I" = (/obj/effect/wallframe_spawn/reinforced,/turf/simulated/floor/tiled/white,/area/map_template/aquarium/deadly)
"J" = (/obj/effect/fluid_mapped,/obj/random/contraband,/obj/effect/decal/remains,/turf/simulated/floor/beach/sand,/area/map_template/aquarium/deadly)
"K" = (/obj/machinery/door/airlock,/turf/simulated/floor/tiled/white,/area/map_template/aquarium/deadly)
"L" = (/obj/structure/table/standard{name = "plastic table frame"},/obj/item/weapon/storage/firstaid/surgery,/turf/simulated/floor/tiled/white,/area/map_template/aquarium/deadly)
"M" = (/obj/machinery/light,/turf/simulated/floor/tiled/white,/area/map_template/aquarium/deadly)
"N" = (/obj/structure/table/standard{name = "plastic table frame"},/obj/machinery/light,/obj/machinery/recharger,/turf/simulated/floor/tiled/white,/area/map_template/aquarium/deadly)
"O" = (/obj/structure/table/standard{name = "plastic table frame"},/obj/item/weapon/storage/firstaid/adv,/turf/simulated/floor/tiled/white,/area/map_template/aquarium/deadly)
"P" = (/obj/machinery/light,/obj/machinery/gibber,/turf/simulated/floor/tiled/white,/area/map_template/aquarium/deadly)
"Q" = (/obj/structure/table/standard{name = "plastic table frame"},/obj/random/masks,/turf/simulated/floor/tiled/white,/area/map_template/aquarium/deadly)
"R" = (/obj/effect/fluid_mapped,/mob/living/simple_animal/hostile/aquatic/shark/huge,/turf/simulated/floor/beach/sand,/area/map_template/aquarium/deadly)
"S" = (/obj/effect/paint_stripe/red,/turf/simulated/wall/r_wall,/area/map_template/aquarium/deadly)
"T" = (/obj/random/tool,/turf/simulated/floor/plating,/area/map_template/aquarium/deadly)
"V" = (/obj/structure/table/standard{name = "plastic table frame"},/obj/random/loot,/obj/random/medical,/turf/simulated/floor/tiled/white,/area/map_template/aquarium/deadly)
"W" = (/obj/structure/table/standard{name = "plastic table frame"},/obj/random/medical,/obj/random/medical,/turf/simulated/floor/tiled/white,/area/map_template/aquarium/deadly)

(1,1,1) = {"
aSScbbSSSbbcSSa
aSdefghSijklmSa
ablllllnlllToba
SSSSSSSSSnSlpba
SqSrsuvrStSnbSS
bqSrJRrrSnSqwxS
bqSrursryhSqqqc
bqSzAzAAScSqBqc
bqSCDDDESFbqqqc
bqSGGHIISFbqVqc
bqqqqqqqqqKqLqc
bqqqqqqqqqcqMqS
SqNOWPQSnSSbbSS
SSbbbbSSlSaaaaa
aaaaaaaSnSaaaaa
"}
