"aa" = (/turf/space,/area/space)
"ab" = (/obj/structure/cable{d1 = 4; d2 = 8; icon_state = "4-8"; pixel_y = 0},/obj/structure/cable{d1 = 1; d2 = 2; icon_state = "1-2"},/turf/simulated/floor/plating,/area/space)
"ac" = (/obj/effect/landmark/start{name = "Captain"},/turf/simulated/floor/plating,/area/space)
"ad" = (/obj/effect/landmark/start{name = "Cargo Technician"},/turf/simulated/floor/plating,/area/space)
"ae" = (/obj/effect/landmark/start{name = "Chief Engineer"},/turf/simulated/floor/plating,/area/space)
"af" = (/obj/effect/landmark/start{name = "Cook"},/turf/simulated/floor/plating,/area/space)
"ag" = (/obj/effect/landmark/start{name = "Deck Hand"},/turf/simulated/floor/plating,/area/space)
"ah" = (/obj/effect/landmark/start{name = "Doc"},/turf/simulated/floor/plating,/area/space)
"ai" = (/obj/effect/landmark/start{name = "Guard"},/turf/simulated/floor/plating,/area/space)
"aj" = (/obj/effect/landmark/start{name = "Junior Engineer"},/turf/simulated/floor/plating,/area/space)
"ak" = (/obj/effect/landmark/start{name = "Psion"},/turf/simulated/floor/plating,/area/space)
"al" = (/obj/effect/landmark/start{name = "Scientist"},/turf/simulated/floor/plating,/area/space)
"am" = (/turf/simulated/wall,/area/space)
"an" = (/obj/structure/table/standard,/obj/random_multi/single_item/captains_spare_id,/turf/simulated/floor/tiled,/area/space)
"ao" = (/obj/machinery/newscaster/security_unit{pixel_x = 30},/obj/machinery/newscaster{pixel_x = -28},/obj/machinery/newscaster{pixel_y = -28},/obj/machinery/newscaster{pixel_x = 0; pixel_y = 32},/turf/simulated/floor/plating,/area/space)
"ap" = (/obj/effect/landmark{name = "JoinLateCryo"},/turf/simulated/floor/plating,/area/space)
"aq" = (/obj/effect/landmark{name = "Observer-Start"},/turf/simulated/floor/plating,/area/space)
"ar" = (/obj/effect/landmark{name = "carpspawn"},/turf/simulated/floor/plating,/area/space)
"as" = (/obj/machinery/atmospherics/pipe/simple/hidden/supply,/obj/machinery/atmospherics/pipe/simple/hidden/scrubbers,/turf/simulated/floor/plating,/area/space)
"at" = (/obj/machinery/light{icon_state = "tube1"; dir = 1},/obj/machinery/light_switch{pixel_y = 25},/turf/simulated/floor/plating,/area/space)
"au" = (/obj/structure/sign/warning/fire{pixel_y = 32},/obj/machinery/atmospherics/portables_connector,/turf/simulated/floor/plating,/area/space)
"av" = (/obj/machinery/atmospherics/pipe/tank/carbon_dioxide,/turf/simulated/floor/plating,/area/space)
"aw" = (/obj/machinery/atmospherics/portables_connector,/turf/simulated/floor/plating,/area/space)
"ax" = (/obj/machinery/atmospherics/portables_connector,/obj/machinery/portable_atmospherics/canister/phoron,/obj/machinery/camera/network/engineering,/turf/simulated/floor/plating,/area/space)
"ay" = (/obj/machinery/atmospherics/portables_connector,/obj/machinery/portable_atmospherics/canister/oxygen,/obj/machinery/light{icon_state = "tube1"; dir = 1},/turf/simulated/floor/plating,/area/space)
"az" = (/obj/machinery/atmospherics/pipe/simple/hidden/supply,/obj/machinery/atmospherics/pipe/simple/hidden/scrubbers{icon_state = "intact-scrubbers"; dir = 5},/obj/machinery/alarm{dir = 4; icon_state = "alarm0"; pixel_x = -24},/turf/simulated/floor/plating,/area/space)
"aA" = (/obj/machinery/atmospherics/pipe/simple/hidden/scrubbers{icon_state = "intact-scrubbers"; dir = 4},/turf/simulated/floor/plating,/area/space)
"aB" = (/obj/machinery/atmospherics/pipe/manifold/visible/fuel{icon_state = "map"; dir = 8},/obj/machinery/atmospherics/pipe/simple/hidden/scrubbers{icon_state = "intact-scrubbers"; dir = 4},/turf/simulated/floor/plating,/area/space)
"aC" = (/obj/machinery/meter,/obj/machinery/atmospherics/pipe/manifold/visible/fuel,/obj/machinery/atmospherics/pipe/simple/hidden/scrubbers{icon_state = "intact-scrubbers"; dir = 4},/turf/simulated/floor/plating,/area/space)
"aD" = (/obj/machinery/atmospherics/pipe/simple/hidden/fuel{icon_state = "intact"; dir = 9},/obj/machinery/atmospherics/pipe/simple/hidden/scrubbers{icon_state = "intact-scrubbers"; dir = 4},/turf/simulated/floor/plating,/area/space)
"aE" = (/obj/machinery/atmospherics/pipe/simple/visible/green{icon_state = "intact"; dir = 5},/turf/simulated/floor/plating,/area/space)
"aF" = (/obj/machinery/atmospherics/omni/mixer{tag_north = 1; tag_north_con = 0.36; tag_south = 2; tag_west = 1; tag_west_con = 0.64},/turf/simulated/floor/plating,/area/space)
"aG" = (/obj/structure/window/phoronreinforced{icon_state = "phoronrwindow"; dir = 8},/obj/structure/window/phoronreinforced{icon_state = "phoronrwindow"; dir = 1},/obj/machinery/atmospherics/pipe/simple/heat_exchanging/junction,/turf/simulated/floor/reinforced/airless,/area/space)
"aH" = (/obj/structure/window/phoronreinforced{icon_state = "phoronrwindow"; dir = 1},/obj/machinery/meter/turf,/obj/machinery/atmospherics/pipe/simple/heat_exchanging{dir = 6},/turf/simulated/floor/reinforced/airless,/area/space)
"aI" = (/obj/structure/window/phoronreinforced{icon_state = "phoronrwindow"; dir = 4},/obj/structure/window/phoronreinforced{icon_state = "phoronrwindow"; dir = 1},/obj/machinery/atmospherics/unary/outlet_injector{dir = 4; icon_state = "map_injector"; use_power = 1},/obj/machinery/atmospherics/pipe/simple/heat_exchanging{dir = 10},/turf/simulated/floor/reinforced/airless,/area/space)
"aJ" = (/obj/structure/window/phoronreinforced,/obj/machinery/atmospherics/binary/pump{dir = 8},/turf/simulated/floor/plating,/area/space)
"aK" = (/obj/machinery/atmospherics/pipe/simple/visible/green{icon_state = "intact"; dir = 4},/turf/simulated/floor/plating,/area/space)
"aL" = (/obj/machinery/meter,/obj/machinery/atmospherics/pipe/simple/visible/green{dir = 9; icon_state = "intact"},/turf/simulated/floor/plating,/area/space)
"aM" = (/obj/machinery/atmospherics/valve/open{icon_state = "map_valve1"; dir = 4},/turf/simulated/floor/plating,/area/space)
"aN" = (/obj/machinery/atmospherics/pipe/simple/hidden/fuel{icon_state = "intact"; dir = 10},/turf/simulated/floor/plating,/area/space)
"aO" = (/obj/structure/window/phoronreinforced{icon_state = "phoronrwindow"; dir = 8},/obj/machinery/atmospherics/pipe/simple/heat_exchanging,/turf/simulated/floor/reinforced/airless,/area/space)
"aP" = (/obj/machinery/igniter{id = "engine"},/obj/machinery/atmospherics/pipe/simple/heat_exchanging,/turf/simulated/floor/reinforced/airless,/area/space)
"aQ" = (/obj/machinery/atmospherics/pipe/simple/heat_exchanging,/turf/simulated/floor/reinforced/airless,/area/space)
"aR" = (/obj/machinery/door/blast/regular{id = "scram"},/turf/simulated/floor/reinforced/airless,/area/space)
"aS" = (/obj/effect/floor_decal/industrial/warning{icon_state = "warning"; dir = 8},/turf/simulated/floor/plating,/area/space)
"aT" = (/turf/simulated/floor/plating,/area/space)
"aU" = (/obj/machinery/atmospherics/pipe/simple/hidden/fuel{icon_state = "intact"; dir = 6},/turf/simulated/floor/plating,/area/space)
"aV" = (/obj/machinery/atmospherics/pipe/simple/hidden/black{icon_state = "intact"; dir = 6},/turf/simulated/floor/plating,/area/space)
"aW" = (/obj/machinery/atmospherics/pipe/simple/hidden/fuel,/obj/machinery/atmospherics/binary/pump{dir = 8},/turf/simulated/floor/plating,/area/space)
"aX" = (/obj/structure/window/phoronreinforced{icon_state = "phoronrwindow"; dir = 8},/obj/structure/window/phoronreinforced,/obj/machinery/atmospherics/pipe/simple/heat_exchanging{dir = 5},/obj/machinery/atmospherics/unary/vent_pump/engine{icon_state = "map_vent"; dir = 8; use_power = 1; pump_direction = 0; external_pressure_bound = 4000; external_pressure_bound_default = 4000},/turf/simulated/floor/reinforced,/area/space)
"aY" = (/obj/structure/window/phoronreinforced,/obj/machinery/atmospherics/pipe/simple/heat_exchanging{dir = 9},/turf/simulated/floor/reinforced,/area/space)
"aZ" = (/obj/structure/window/phoronreinforced,/obj/structure/window/phoronreinforced{icon_state = "phoronrwindow"; dir = 4},/obj/machinery/atmospherics/pipe/simple/heat_exchanging/junction{dir = 1},/turf/simulated/floor/reinforced,/area/space)
"ba" = (/obj/structure/window/phoronreinforced{icon_state = "phoronrwindow"; dir = 1},/turf/simulated/floor/plating,/area/space)
"bb" = (/obj/machinery/atmospherics/pipe/simple/hidden/fuel,/turf/simulated/floor/plating,/area/space)
"bc" = (/obj/machinery/atmospherics/pipe/manifold/hidden/black{icon_state = "map"; dir = 8},/turf/simulated/floor/plating,/area/space)
"bd" = (/obj/machinery/atmospherics/pipe/simple/hidden/fuel,/obj/machinery/atmospherics/pipe/simple/hidden/black{icon_state = "intact"; dir = 8},/turf/simulated/floor/plating,/area/space)
"be" = (/obj/machinery/atmospherics/pipe/simple/hidden/black{icon_state = "intact"; dir = 4},/turf/simulated/floor/plating,/area/space)
"bf" = (/obj/machinery/atmospherics/binary/pump{dir = 8},/turf/simulated/floor/plating,/area/space)
"bg" = (/obj/machinery/atmospherics/pipe/manifold/visible/fuel,/turf/simulated/floor/plating,/area/space)
"bh" = (/obj/machinery/firealarm{dir = 8; pixel_x = -24; pixel_y = 0},/obj/machinery/atmospherics/pipe/simple/hidden/black{icon_state = "intact"; dir = 1},/obj/effect/floor_decal/industrial/warning{icon_state = "warning"; dir = 10},/turf/simulated/floor/plating,/area/space)
"bi" = (/obj/machinery/light/small,/obj/effect/floor_decal/industrial/warning,/obj/machinery/atmospherics/pipe/simple/hidden/fuel{icon_state = "intact"; dir = 5},/obj/machinery/camera/network/engineering{icon_state = "camera"; dir = 1},/turf/simulated/floor/plating,/area/space)
"bj" = (/obj/structure/window/reinforced,/obj/effect/floor_decal/industrial/warning,/obj/machinery/atmospherics/pipe/manifold/visible/fuel{icon_state = "map"; dir = 1},/turf/simulated/floor/plating,/area/space)
"bk" = (/obj/structure/window/reinforced,/obj/machinery/atmospherics/pipe/manifold/visible/fuel{icon_state = "map"; dir = 1},/obj/effect/floor_decal/industrial/warning,/turf/simulated/floor/plating,/area/space)
"bl" = (/obj/structure/window/reinforced,/obj/effect/floor_decal/industrial/warning,/obj/machinery/atmospherics/pipe/manifold4w/hidden/fuel,/turf/simulated/floor/plating,/area/space)
"bm" = (/obj/effect/floor_decal/industrial/warning,/obj/machinery/light/small,/obj/machinery/atmospherics/pipe/simple/hidden/fuel{icon_state = "intact"; dir = 9},/turf/simulated/floor/plating,/area/space)
"bn" = (/obj/effect/floor_decal/industrial/warning{icon_state = "warning"; dir = 6},/turf/simulated/floor/plating,/area/space)
"bo" = (/obj/machinery/atmospherics/pipe/simple/hidden/black{icon_state = "intact"; dir = 1},/turf/simulated/wall/r_wall,/area/space)
"bp" = (/turf/simulated/wall/r_wall,/area/space)
"bq" = (/obj/machinery/atmospherics/unary/engine{icon_state = "nozzle"; dir = 1},/turf/simulated/floor/plating,/area/space)
"br" = (/obj/machinery/door/blast/regular{id = "scram"},/turf/simulated/floor/plating,/area/space)
"bs" = (/obj/machinery/atmospherics/unary/vent_pump/high_volume{dir = 1; external_pressure_bound = 140; external_pressure_bound_default = 140; icon_state = "map_vent_out"; pressure_checks = 1; pressure_checks_default = 1; use_power = 1},/turf/simulated/floor/airless,/area/space)
"bt" = (/obj/structure/sign/warning/hot_exhaust{pixel_y = 32},/obj/machinery/door/blast/regular{density = 0; dir = 4; icon_state = "pdoor0"; id = "scraplock"; name = "External Blast Doors"; opacity = 0},/turf/simulated/floor/airless,/area/space)
"bu" = (/turf/simulated/floor/airless,/area/space)
"bS" = (/obj/structure/cable{d1 = 1; d2 = 8; icon_state = "1-8"},/turf/simulated/floor/plating,/area/space)
"cH" = (/obj/machinery/atmospherics/unary/vent_pump/on{icon_state = "map_vent_out"; dir = 1},/turf/simulated/floor/plating,/area/space)
"cJ" = (/obj/structure/cable{d1 = 32; d2 = 1; icon_state = "32-1"},/turf/simulated/floor/plating,/area/space)
"cK" = (/obj/structure/cable,/obj/structure/cable{d2 = 8; icon_state = "0-8"},/obj/structure/cable{icon_state = "0-2"; d2 = 2},/obj/structure/cable{icon_state = "0-4"; d2 = 4},/turf/simulated/floor/plating,/area/space)
"cL" = (/obj/structure/cable{d1 = 2; d2 = 4; icon_state = "2-4"},/turf/simulated/floor/plating,/area/space)
"cM" = (/obj/structure/cable{icon_state = "2-8"},/turf/simulated/floor/plating,/area/space)
"cR" = (/obj/structure/cable{d1 = 32; d2 = 8; icon_state = "32-8"},/turf/simulated/floor/plating,/area/space)
"cS" = (/obj/structure/cable{d1 = 16; d2 = 0; icon_state = "16-0"},/turf/simulated/floor/plating,/area/space)
"cT" = (/obj/structure/cable{d1 = 32; d2 = 4; icon_state = "32-4"},/turf/simulated/floor/plating,/area/space)
"cU" = (/obj/structure/cable{d1 = 1; d2 = 4; icon_state = "1-4"},/turf/simulated/floor/plating,/area/space)
"dh" = (/obj/structure/cable{d1 = 32; d2 = 2; icon_state = "32-2"},/turf/simulated/floor/plating,/area/space)
"ih" = (/obj/machinery/light_switch{pixel_y = -25},/turf/simulated/floor/plating,/area/space)
"ii" = (/obj/machinery/alarm{dir = 8; icon_state = "alarm0"; pixel_x = 24},/turf/simulated/floor/plating,/area/space)
"ij" = (/obj/machinery/alarm{dir = 4; icon_state = "alarm0"; pixel_x = -24},/turf/simulated/floor/plating,/area/space)
"ik" = (/obj/machinery/light_switch{pixel_x = 25},/turf/simulated/floor/plating,/area/space)
"il" = (/obj/machinery/light_switch{pixel_x = -25},/turf/simulated/floor/plating,/area/space)
"im" = (/obj/machinery/alarm{pixel_y = 16},/turf/simulated/floor/plating,/area/space)
"in" = (/obj/machinery/light_switch{pixel_y = 25},/turf/simulated/floor/plating,/area/space)
"io" = (/obj/machinery/atmospherics/unary/vent_pump/on,/turf/simulated/floor/plating,/area/space)
"ip" = (/obj/machinery/atmospherics/unary/vent_pump/on{icon_state = "map_vent_out"; dir = 4},/turf/simulated/floor/plating,/area/space)
"iq" = (/obj/machinery/atmospherics/unary/vent_pump/on{icon_state = "map_vent_out"; dir = 8},/turf/simulated/floor/plating,/area/space)
"ir" = (/obj/machinery/atmospherics/unary/vent_scrubber/on,/turf/simulated/floor/plating,/area/space)
"is" = (/obj/machinery/atmospherics/unary/vent_scrubber/on{icon_state = "map_scrubber_on"; dir = 4},/turf/simulated/floor/plating,/area/space)
"it" = (/obj/machinery/atmospherics/unary/vent_scrubber/on{icon_state = "map_scrubber_on"; dir = 8},/turf/simulated/floor/plating,/area/space)
"iu" = (/obj/machinery/atmospherics/unary/vent_scrubber/on{dir = 1},/turf/simulated/floor/plating,/area/space)

(1,1,1) = {"
aaaaaaaaaaaaaaaaaaaaaaaaaaaaaaaaaaaaaaaaaaaaaaaaaaaaaaaaaaaaaaaaaaaaaaaaaaaaaaaaaaaaaaaaaaaaaaaaaaaaaaaaaaaaaaaaaaaaaaaaaaaaaaaaaaaaaaaaaaaaaaaaaaaaaa
aaaaaaaaaaaaaaaaaaaaaaaaaaaaaaaaaaaaaaaaaaaaaaaaaaaaaaaaaaaaaaaaaaaaaaaaaaaaaaaaaaaaaaaaaaaaaaaaaaaaaaaaaaaaaaaaaaaaaaaaaaaaaaaaaaaaaaaaaaaaaaaaaaaaaa
aaaaaaaaaaaaaaaaaaaaaaaaaaaaaaaaaaaaaaaaaaaaaaaaaaaaaaaaaaaaaaaaaaaaaaaaaaaaaaaaaaaaaaaaaaaaaaaaaaaaaaaaaaaaaaaaaaaaaaaaaaaaaaaaaaaaaaaaaaaaaaaaaaaaaa
aaaaaaaaaaaaaaaaaaaaaaaaaaaaaaaaaaaaaaaaaaaaaaaaaaaaaaaaaaaaaaaaaaaaaaaaaaaaaaaaaaaaaaaaaaaaaaaaaaaaaaaaaaaaaaaaaaaaaaaaaaaaaaaaaaaaaaaaaaaaaaaaaaaaaa
aaaaaaaaaaaaaaaaaaaaaaaaaaaaaaaaaaaaaaaaaaaaaaaaaaaaaaaaaaaaaaaaaaaaaaaaaaaaaaaaaaaaaaaaaaaaaaaaaaaaaaaaaaaaaaaaaaaaaaaaaaaaaaaaaaaaaaaaaaaaaaaaaaaaaa
aaaaaaaaaaaaaaaaaaaaaaaaaaaaaaaaaaaaaaaaaaaaaaaaaaaaaaaaaaaaaaaaaaaaaaaaaaaaaaaaaaaaaaaaaaaaaaaaaaaaaaaaaaaaaaaaaaaaaaaaaaaaaaaaaaaaaaaaaaaaaaaaaaaaaa
aaaaaaaaaaaaaaaaaaaaaaaaaaaaaaaaaaaaaaaaaaaaaaaaaaaaaaaaaaaaaaaaaaaaaaaaaaaaaaaaaaaaaaaaaaaaaaaaaaaaaaaaaaaaaaaaaaaaaaaaaaaaaaaaaaaaaaaaaaaaaaaaaaaaaa
aaaaaaaaaaaaaaaaaaaaaaaaaaaaaaaaaaaaaaaaaaaaaaaaaaaaaaaaaaaaaaaaaaaaaaaaaaaaaaaaaaaaaaaaaaaaaaaaaaaaaaaaaaaaaaaaaaaaaaaaaaaaaaaaaaaaaaaaaaaaaaaaaaaaaa
aaaaaaaaaaaaaaaaaaaaaaaaaaaaaaaaaaaaaaaaaaaaaaaaaaaaaaaaaaaaaaaaaaaaaaaaaaaaaaaaaaaaaaaaaaaaaaaaaaaaaaaaaaaaaaaaaaaaaaaaaaaaaaaaaaaaaaaaaaaaaaaaaaaaaa
aaaaaaaaaaaaaaaaaaaaaaaaaaaaaaaaaaaaaaaaaaaaaaaaaaaaaaaaaaaaaaaaaaaaaaaaaaaaaaaaaaaaaaaaaaaaaaaaaaaaaaaaaaaaaaaaaaaaaaaaaaaaaaaaaaaaaaaaaaaaaaaaaaaaaa
aaaaaaaaaaaaaaaaaaaaaaaaaaaaaaaaaaaaaaaaaaaaaaaaaaaaaaaaaaaaaaaaaaaaaaaaaaaaaaaaaaaaaaaaaaaaaaaaaaaaaaaaaaaaaaaaaaaaaaaaaaaaaaaaaaaaaaaaaaaaaaaaaaaaaa
aaaaaaaaaaaaaaaaaaaaaaaaaaaaaaaaaaaaaaaaaaaaaaaaaaaaaaaaaaaaaaaaaaaaaaaaaaaaaaaaaaaaaaaaaaaaaaaaaaaaaaaaaaaaaaaaaaaaaaaaaaaaaaaaaaaaaaaaaaaaaaaaaaaaaa
aaaaaaaaaaaaaaaaaaaaaaaaaaaaaaaaaaaaaaaaaaaaaaaaaaaaaaaaaaaaaaaaaaaaaaaaaaaaaaaaaaaaaaaaaaaaaaaaaaaaaaaaaaaaaaaaaaaaaaaaaaaaaaaaaaaaaaaaaaaaaaaaaaaaaa
aaaaaaaaaaaaaaaaaaaaaaaaaaaaaaaaaaaaaaaaaaaaaaaaaaaaaaaaaaaaaaaaaaaaaaaaaaaaaaaaaaaaaaaaaaaaaaaaaaaaaaaaaaaaaaaaaaaaaaaaaaaaaaaaaaaaaaaaaaaaaaaaaaaaaa
aaaaaaaaaaaaaaaaaaaaaaaaaaaaaaaaaaaaaaaaaaaaaaaaaaaaaaaaaaaaaaaaaaaaaaaaaaaaaaaaaaaaaaaaaaaaaaaaaaaaaaaaaaaaaaaaaaaaaaaaaaaaaaaaaaaaaaaaaaaaaaaaaaaaaa
aaaaaaaaaaaaaaaaaaaaaaaaaaaaaaaaaaaaaaaaaaaaaaaaaaaaaaaaaaaaaaaaaaaaaaaaaaaaaaaaaaaaaaaaaaaaaaaaaaaaaaaaaaaaaaaaaaaaaaaaaaaaaaaaaaaaaaaaaaaaaaaaaaaaaa
aaaaaaaaaaaaaaaaaaaaaaaaaaaaaaaaaaaaaaaaaaaaaaaaaaaaaaaaaaaaaaaaaaaaaaaaaaaaaaaaaaaaaaaaaaaaaaaaaaaaaaaaaaaaaaaaaaaaaaaaaaaaaaaaaaaaaaaaaaaaaaaaaaaaaa
aaaaaaaaaaaaaaaaaaaaaaaaaaaaaaaaaaaaaaaaaaaaaaaaaaaaaaaaaaaaaaaaaaaaaaaaaaaaaaaaaaaaaaaaaaaaaaaaaaaaaaaaaaaaaaaaaaaaaaaaaaaaaaaaaaaaaaaaaaaaaaaaaaaaaa
aaaaaaaaaaaaaaaaaaaaaaaaaaaaaaaaaaaaaaaaaaaaaaaaaaaaaaaaaaaaaaaaaaaaaaaaaaaaaaaaaaaaaaaaaaaaaaaaaaaaaaaaaaaaaaaaaaaaaaaaaaaaaaaaaaaaaaaaaaaaaaaaaaaaaa
aaaaaaaaaaaaaaaaaaaaaaaaaaaaaaaaaaaaaaaaaaaaaaaaaaaaaaaaaaaaaaaaaaaaaaaaaaaaaaaaaaaaaaaaaaaaaaaaaaaaaaaaaaaaaaaaaaaaaaaaaaaaaaaaaaaaaaaaaaaaaaaaaaaaaa
aaaaaaaaaaaaaaaaaaaaaaaaaaaaaaaaaaaaaaaaaaaaaaaaaaaaaaaaaaaaaaaaaaaaaaaaaaaaaaaaaaaaaaaaaaaaaaaaaaaaaaaaaaaaaaaaaaaaaaaaaaaaaaaaaaaaaaaaaaaaaaaaaaaaaa
aaaaaaaaaaaaaaaaaaaaaaaaaaaaaaaaaaaaaaaaaaaaaaaaaaaaaaaaaaaaaaaaaaaaaaaaaaaaaaaaaaaaaaaaaaaaaaaaaaaaaaaaaaaaaaaaaaaaaaaaaaaaaaaaaaaaaaaaaaaaaaaaaaaaaa
aaaaaaaaaaaaaaaaaaaaaaaaaaaaaaaaaaaaaaaaaaaaaaaaaaaaaaaaaaaaaaaaaaaaaaaaaaaaaaaaaaaaaaaaaaaaaaaaaaaaaaaaaaaaaaaaaaaaaaaaaaaaaaaaaaaaaaaaaaaaaaaaaaaaaa
aaaaaaaaaaaaaaaaaaaaaaaaaaaaaaaaaaaaaaaaaaaaaaaaaaaaaaaaaaaaaaaaaaaaaaaaaaaaaaaaaaaaaaaaaaaaaaaaaaaaaaaaaaaaaaaaaaaaaaaaaaaaaaaaaaaaaaaaaaaaaaaaaaaaaa
aaaaaaaaaaaaaaaaaaaaaaaaaaaaaaaaaaaaaaaaaaaaaaaaaaaaaaaaaaaaaaaaaaaaaaaaaaaaaaaaaaaaaaaaaaaaaaaaaaaaaaaaaaaaaaaaaaaaaaaaaaaaaaaaaaaaaaaaaaaaaaaaaaaaaa
aaaaaaaaaaaaaaaaaaaaaaaaaaaaaaaaaaaaaaaaaaaaaaaaaaaaaaaaaaaaaaaaaaaaaaaaaaaaaaaaaaaaaaaaaaaaaaaaaaaaaaaaaaaaaaaaaaaaaaaaaaaaaaaaaaaaaaaaaaaaaaaaaaaaaa
aaaaaaaaaaaaaaaaaaaaaaaaaaaaaaaaaaaaaaaaaaaaaaaaaaaaaaaaaaaaaaaaaaaaaaaaaaaaaaaaaaaaaaaaaaaaaaaaaaaaaaaaaaaaaaaaaaaaaaaaaaaaaaaaaaaaaaaaaaaaaaaaaaaaaa
aaaaaaaaaaaaaaaaaaaaaaaaaaaaaaaaaaaaaaaaaaaaaaaaaaaaaaaaaaaaaaaaaaaaaaaaaaaaaaaaaaaaaaaaaaaaaaaaaaaaaaaaaaaaaaaaaaaaaaaaaaaaaaaaaaaaaaaaaaaaaaaaaaaaaa
aaaaaaaaaaaaaaaaaaaaaaaaaaaaaaaaaaaaaaaaaaaaaaaaaaaaaaaaaaaaaaaaaaaaaaaaaaaaaaaaaaaaaaaaaaaaaaaaaaaaaaaaaaaaaaaaaaaaaaaaaaaaaaaaaaaaaaaaaaaaaaaaaaaaaa
aaaaaaaaaaaaaaaaaaaaaaaaaaaaaaaaaaaaaaaaaaaaaaaaaaaaaaaaaaaaaaaaaaaaaaaaaaaaaaaaaaaaaaaaaaaaaaaaaaaaaaaaaaaaaaaaaaaaaaaaaaaaaaaaaaaaaaaaaaaaaaaaaaaaaa
aaaaaaaaaaaaaaaaaaaaaaaaaaaaaaaaaaaaaaaaaaaaaaaaaaaaaaaaaaaaaaaaaaaaaaaaaaaaaaaaaaaaaaaaaaaaaaaaaaaaaaaaaaaaaaaaaaaaaaaaaaaaaaaaaaaaaaaaaaaaaaaaaaaaaa
aaaaaaaaaaaaaaaaaaaaaaaaaaaaaaaaaaaaaaaaaaaaaaaaaaaaaaaaaaaaaaaaaaaaaaaaaaaaaaaaaaaaaaaaaaaaaaaaaaaaaaaaaaaaaaaaaaaaaaaaaaaaaaaaaaaaaaaaaaaaaaaaaaaaaa
aaaaaaaaaaaaaaaaaaaaaaaaaaaaaaaaaaaaaaaaaaaaaaaaaaaaaaaaaaaaaaaaaaaaaaaaaaaaaaaaaaaaaaaaaaaaaaaaaaaaaaaaaaaaaaaaaaaaaaaaaaaaaaaaaaaaaaaaaaaaaaaaaaaaaa
aaaaaaaaaaaaaaaaaaaaaaaaaaaaaaaaaaaaaaaaaaaaaaaaaaaaaaaaaaaaaaaaaaaaaaaaaaaaaaaaaaaaaaaaaaaaaaaaaaaaaaaaaaaaaaaaaaaaaaaaaaaaaaaaaaaaaaaaaaaaaaaaaaaaaa
aaaaaaaaaaaaaaaaaaaaaaaaaaaaaaaaaaaaaaaaaaaaaaaaaaaaaaaaaaaaaaaaaaaaaaaaaaaaaaaaaaaaaaaaaaaaaaaaaaaaaaaaaaaaaaaaaaaaaaaaaaaaaaaaaaaaaaaaaaaaaaaaaaaaaa
aaaaaaaaaaaaaaaaaaaaaaaaaaaaaaaaaaaaaaaaaaaaaaaaaaaaaaaaaaaaaaaaaaaaaaaaaaaaaaaaaaaaaaaaaaaaaaaaaaaaaaaaaaaaaaaaaaaaaaaaaaaaaaaaaaaaaaaaaaaaaaaaaaaaaa
aaaaaaaaaaaaaaaaaaaaaaaaaaaaaaaaaaaaaaaaaaaaaaaaaaaaaaaaaaaaaaaaaaaaaaaaaaaaaaaaaaaaaaaaaaaaaaaaaaaaaaaaaaaaaaaaaaaaaaaaaaaaaaaaaaaaaaaaaaaaaaaaaaaaaa
aaaaaaaaaaaaaaaaaaaaaaaaaaaaaaaaaaaaaaaaaaaaaaaaaaaaaaaaaaaaaaaaaaaaaaaaaaaaaaaaaaaaaaaaaaaaaaaaaaaaaaaaaaaaaaaaaaaaaaaaaaaaaaaaaaaaaaaaaaaaaaaaaaaaaa
aaaaaaaaaaaaaaaaaaaaaaaaaaaaaaaaaaaaaaaaaaaaaaaaaaaaaaaaaaaaaaaaaaaaaaaaaaaaaaaaaaaaaaaaaaaaaaaaaaaaaaaaaaaaaaaaaaaaaaaaaaaaaaaaaaaaaaaaaaaaaaaaaaaaaa
aaaaaaaaaaaaaaaaaaaaaaaaaaaaaaaaaaaaaaaaaaaaaaaaaaaaaaaaaaaaaaaaaaaaaaaaaaaaaaaaaaaaaaaaaaaaaaaaaaaaaaaaaaaaaaaaaaaaaaaaaaaaaaaaaaaaaaaaaaaaaaaaaaaaaa
aaaaaaaaaaaaaaaaaaaaaaaaaaaaaaaaaaaaaaaaaaaaaaaaaaaaaaaaaaaaaaaaaaaaaaaaaaaaaaaaaaaaaaaaaaaaaaaaaaaaaaaaaaaaaaaaaaaaaaaaaaaaaaaaaaaaaaaaaaaaaaaaaaaaaa
aaaaaaaaaaaaaaaaaaaaaaaaaaaaaaaaaaaaaaaaaaaaaaaaaaaaaaaaaaaaaaaaaaaaaaaaaaaaaaaaaaaaaaaaaaaaaaaaaaaaaaaaaaaaaaaaaaaaaaaaaaaaaaaaaaaaaaaaaaaaaaaaaaaaaa
aaaaaaaaaaaaaaaaaaaaaaaaaaaaaaaaaaaaaaaaaaaaaaaaaaaaaaaaaaaaaaaaaaaaaaaaaaaaaaaaaaaaaaaaaaaaaaaaaaaaaaaaaaaaaaaaaaaaaaaaaaaaaaaaaaaaaaaaaaaaaaaaaaaaaa
aaaaaaaaaaaaaaaaaaaaaaaaaaaaaaaaaaaaaaaaaaaaaaaaaaaaaaaaaaaaaaaaaaaaaaaaaaaaaaaaaaaaaaaaaaaaaaaaaaaaaaaaaaaaaaaaaaaaaaaaaaaaaaaaaaaaaaaaaaaaaaaaaaaaaa
aaaaaaaaaaaaaaaaaaaaaaaaaaaaaaaaaaaaaaaaaaaaaaaaaaaaaaaaaaaaaaaaaaaaaaaaaaaaaaaaaaaaaaaaaaaaaaaaaaaaaaaaaaaaaaaaaaaaaaaaaaaaaaaaaaaaaaaaaaaaaaaaaaaaaa
aaaaaaaaaaaaaaaaaaaaaaaaaaaaaaaaaaaaaaaaaaaaaaaaaaaaaaaaaaaaaaaaaaaaaaaaaaaaaaaaaaaaaaaaaaaaaaaaaaaaaaaaaaaaaaaaaaaaaaaaaaaaaaaaaaaaaaaaaaaaaaaaaaaaaa
aaaaaaaaaaaaaaaaaaaaaaaaaaaaaaaaaaaaaaaaaaaaaaaaaaaaaaaaaaaaaaaaaaaaaaaaaaaaaaaaaaaaaaaaaaaaaaaaaaaaaaaaaaaaaaaaaaaaaaaaaaaaaaaaaaaaaaaaaaaaaaaaaaaaaa
aaaaaaaaaaaaaaaaaaaaaaaaaaaaaaaaaaaaaaaaaaaaaaaaaaaaaaaaaaaaaaaaaaaaaaaaaaaaaaaaaaaaaaaaaaaaaaaaaaaaaaaaaaaaaaaaaaaaaaaaaaaaaaaaaaaaaaaaaaaaaaaaaaaaaa
aaaaaaaaaaaaaaaaaaaaaaaaaaaaaaaaaaaaaaaaaaaaaaaaaaaaaaaaaaaaaaaaaaaaaaaaaaaaaaaaaaaaaaaaaaaaaaaaaaaaaaaaaaaaaaaaaaaaaaaaaaaaaaaaaaaaaaaaaaaaaaaaaaaaaa
aaaaaaaaaaaaaaaaaaaaaaaaaaaaaaaaaaaaaaaaaaaaaaaaaaaaaaaaaaaaaaaaaaaaaaaaaaaaaaaaaaaaaaaaaaaaaaaaaaaaaaaaaaaaaaaaaaaaaaaaaaaaaaaaaaaaaaaaaaaaaaaaaaaaaa
aaaaaaaaaaaaaaaaaaaaaaaaaaaaaaaaaaaaaaaaaaaaaaaaaaaaaaaaaaaaaaaaaaaaaaaaaaaaaaaaaaaaaaaaaaaaaaaaaaaaaaaaaaaaaaaaaaaaaaaaaaaaaaaaaaaaaaaaaaaaaaaaaaaaaa
aaaaaaaaaaaaaaaaaaaaaaaaaaaaaaaaaaaaaaaaaaaaaaaaaaaaaaaaaaaaaaaaaaaaaaaaaaaaaaaaaaaaaaaaaaaaaaaaaaaaaaaaaaaaaaaaaaaaaaaaaaaaaaaaaaaaaaaaaaaaaaaaaaaaaa
aaaaaaaaaaaaaaaaaaaaaaaaaaaaaaaaaaaaaaaaaaaaaaaaaaaaaaaaaaaaaaaaaaaaaaaaaaaaaaaaaaaaaaaaaaaaaaaaaaaaaaaaaaaaaaaaaaaaaaaaaaaaaaaaaaaaaaaaaaaaaaaaaaaaaa
aaaaaaaaaaaaaaaaaaaaaaaaaaaaaaaaaaaaaaaaaaaaaaaaaaaaaaaaaaaaaaaaaaaaaaaaaaaaaaaaaaaaaaaaaaaaaaaaaaaaaaaaaaaaaaaaaaaaaaaaaaaaaaaaaaaaaaaaaaaaaaaaaaaaaa
aaaaaaaaaaaaaaaaaaaaaaaaaaaaaaaaaaaaaaaaaaaaaaaaaaaaaaaaaaaaaaaaaaaaaaaaaaaaaaaaaaaaaaaaaaaaaaaaaaaaaaaaaaaaaaaaaaaaaaaaaaaaaaaaaaaaaaaaaaaaaaaaaaaaaa
aaaaaaaaaaaaaaaaaaaaaaaaaaaaaaaaaaaaaaaaaaaaaaaaaaaaaaaaaaaaaaaaaaaaaaaaaaaaaaaaaaaaaaaaaaaaaaaaaaaaaaaaaaaaaaaaaaaaaaaaaaaaaaaaaaaaaaaaaaaaaaaaaaaaaa
aaaaaaaaaaaaaaaaaaaaaaaaaaaaaaaaaaaaaaaaaaaaaaaaaaaaaaaaaaaaaaaaaaaaaaaaaaaaaaaaaaaaaaaaaaaaaaaaaaaaaaaaaaaaaaaaaaaaaaaaaaaaaaaaaaaaaaaaaaaaaaaaaaaaaa
aaaaaaaaaaaaaaaaaaaaaaaaaaaaaaaaaaaaaaaaaaaaaaaaaaaaaaaaaaaaaaaaaaaaaaaaaaaaaaaaaaaaaaaaaaaaaaaaaaaaaaaaaaaaaaaaaaaaaaaaaaaaaaaaaaaaaaaaaaaaaaaaaaaaaa
aaaaaaaaaaaaaaaaaaaaaaaaaaaaaaaaaaaaaaaaaaaaaaaaaaaaaaaaaaaaaaaaaaaaaaaaaaaaaaaaaaaaaaaaaaaaaaaaaaaaaaaaaaaaaaaaaaaaaaaaaaaaaaaaaaaaaaaaaaaaaaaaaaaaaa
aaaaaaaaaaaaaaaaaaaaaaaaaaaaaaaaaaaaaaaaaaaaaaaaaaaaaaaaaaaaaaaaaaaaaaaaaaaaaaaaaaaaaaaaaaaaaaaaaaaaaaaaaaaaaaaaaaaaaaaaaaaaaaaaaaaaaaaaaaaaaaaaaaaaaa
aaaaaaaaaaaaaaaaaaaaaaaaaaaaaaaaaaaaaaaaaaaaaaaaaaaaaaaaaaaaaaaaaaaaaaaaaaaaaaaaaaaaaaaaaaaaaaaaaaaaaaaaaaaaaaaaaaaaaaaaaaaaaaaaaaaaaaaaaaaaaaaaaaaaaa
aaaaaaaaaaaaaaaaaaaaaaaaaaaaaaaaaaaaaaaaaaaaaaaaaaaaaaaaaaaaaaaaaaaaaaaaaaaaaaaaaaaaaaaaaaaaaaaaaaaaaaaaaaaaaaaaaaaaaaaaaaaaaaaaaaaaaaaaaaaaaaaaaaaaaa
aaaaaaaaaaaaaaaaaaaaaaaaaaaaaaaaaaaaaaaaaaaaaaaaaaaaaaaaaaaaaaaaaaaaaaaaaaaaaaaaaaaaaaaaaaaaaaaaaaaaaaaaaaaaaaaaaaaaaaaaaaaaaaaaaaaaaaaaaaaaaaaaaaaaaa
aTaTacadaeafagahaiajaTaTaaaaaaaaaaaaaaaaaaaaaaaaaaaaaaaaaaaaaaaaaaaaaaaaaaaaaaaaaaaaaaaaaaaaaaaaaaaaaaaaaaaaaaaaaaaaaaaaaaaaaaaaaaaaaaaaaaaaaaaaaaaaaa
aTaTakalanaTaTihaTaTaTaTaaasatauavawaTaxayaTaaaaaaaaaaaaaaaaaaaaaaaaaaaaaaaaaaaaaaaaaaaaaaaaaaaaaaaaaaaaaaaaaaaaaaaaaaaaaaaaaaaaaaaaaaaaaaaaaaaaaaaaaa
aTaTaTiiamijikamilaTaoaTaaazaAaBaCaDitaEaFaTaaaaaaaaaaaaaaaaaaaaaaaaaaaaaaaaaaaaaaaaaaaaaaaaaaaaaaaaaaaaaaaaaaaaaaaaaaaaaaaaaaaaaaaaaaaaaaaaaaaaaaaaaa
aTaTaTaTimaTaTinaTaTaTaTaacHaTaGaHaIaJaKaLaTaaaaaaaaaaaaaaaaaaaaaaaaaaaaaaaaaaaaaaaaaaaaaaaaaaaaaaaaaaaaaaaaaaaaaaaaaaaaaaaaaaaaaaaaaaaaaaaaaaaaaaaaaa
aTaTaTcJcKcLcMaTioaTaTaTaaaMaNaOaPaQaRaSaUaMaaaaaaaaaaaaaaaaaaaaaaaaaaaaaaaaaaaaaaaaaaaaaaaaaaaaaaaaaaaaaaaaaaaaaaaaaaaaaaaaaaaaaaaaaaaaaaaaaaaaaaaaaa
aTaTcRcScTcUbSipaTiqaTaTaaaVaWaXaYaZbaaTbbaTaaaaaaaaaaaaaaaaaaaaaaaaaaaaaaaaaaaaaaaaaaaaaaaaaaaaaaaaaaaaaaaaaaaaaaaaaaaaaaaaaaaaaaaaaaaaaaaaaaaaaaaaaa
aTaTabdhaTaTaTircHaTaTaTaabcbdbebfbgaMaNbbaTaaaaaaaaaaaaaaaaaaaaaaaaaaaaaaaaaaaaaaaaaaaaaaaaaaaaaaaaaaaaaaaaaaaaaaaaaaaaaaaaaaaaaaaaaaaaaaaaaaaaaaaaaa
aTaTaTaTaTaTisaTitaTaTaTaabhbibjbjbkbkblbmbnaaaaaaaaaaaaaaaaaaaaaaaaaaaaaaaaaaaaaaaaaaaaaaaaaaaaaaaaaaaaaaaaaaaaaaaaaaaaaaaaaaaaaaaaaaaaaaaaaaaaaaaaaa
aTaTaTaTaTaTaTiuaTaTaTaTaabobpbqbqbqbqbqbpbraaaaaaaaaaaaaaaaaaaaaaaaaaaaaaaaaaaaaaaaaaaaaaaaaaaaaaaaaaaaaaaaaaaaaaaaaaaaaaaaaaaaaaaaaaaaaaaaaaaaaaaaaa
aTaTaTapaqaraTaTaTaTaTaTaabsbtbubububububtbuaaaaaaaaaaaaaaaaaaaaaaaaaaaaaaaaaaaaaaaaaaaaaaaaaaaaaaaaaaaaaaaaaaaaaaaaaaaaaaaaaaaaaaaaaaaaaaaaaaaaaaaaaa
aTaTaTaTaTaTaTaTaTaTaTaTaaaaaaaaaaaaaaaaaaaaaaaaaaaaaaaaaaaaaaaaaaaaaaaaaaaaaaaaaaaaaaaaaaaaaaaaaaaaaaaaaaaaaaaaaaaaaaaaaaaaaaaaaaaaaaaaaaaaaaaaaaaaaa
aTaTaTaTaTaTaTaTaTaTaTaTaaaaaaaaaaaaaaaaaaaaaaaaaaaaaaaaaaaaaaaaaaaaaaaaaaaaaaaaaaaaaaaaaaaaaaaaaaaaaaaaaaaaaaaaaaaaaaaaaaaaaaaaaaaaaaaaaaaaaaaaaaaaaa
"}
