"a" = (/turf/template_noop,/area/template_noop)
"b" = (/obj/structure/sign/warning/caution{dir = 1; icon_state = "securearea"; pixel_y = -35},/turf/template_noop,/area/template_noop)
"c" = (/obj/effect/paint/black,/obj/effect/paint_stripe/red,/turf/simulated/wall/r_wall,/area/template_noop)
"d" = (/turf/simulated/floor/greengrid,/area/template_noop)
"e" = (/obj/structure/sign/warning/caution{dir = 8; icon_state = "securearea"; pixel_x = 35},/turf/template_noop,/area/template_noop)
"f" = (/turf/simulated/floor/tiled/techfloor/grid,/area/template_noop)
"g" = (/obj/random/pilruin/mecha,/turf/simulated/floor/tiled/techfloor,/area/template_noop)
"h" = (/obj/structure/sign/warning/caution{dir = 4; icon_state = "securearea"; pixel_x = -35},/turf/template_noop,/area/template_noop)
"i" = (/turf/simulated/floor/tiled/techfloor,/area/template_noop)
"j" = (/turf/template_noop,/area/space)
"k" = (/obj/machinery/door/airlock,/obj/machinery/atmos_protector,/turf/simulated/floor/tiled/techfloor/grid,/area/template_noop)
"l" = (/obj/structure/sign/warning/lethal_turrets{pixel_y = 30},/turf/simulated/floor/tiled/techfloor,/area/template_noop)
"m" = (/obj/effect/catwalk_plated,/turf/template_noop,/area/template_noop)
"n" = (/obj/structure/window/reinforced{dir = 8},/obj/structure/window/reinforced,/turf/simulated/floor/blackgrid,/area/template_noop)
"o" = (/obj/machinery/door/airlock,/obj/machinery/atmos_protector,/turf/simulated/floor/tiled/techfloor,/area/template_noop)
"p" = (/obj/structure/window/reinforced,/obj/structure/window/reinforced{icon_state = "rwindow"; dir = 4},/turf/simulated/floor/blackgrid,/area/template_noop)
"q" = (/obj/structure/sign/warning/lethal_turrets{pixel_y = 30},/obj/effect/catwalk_plated,/turf/simulated/floor/exoplanet/concrete,/area/template_noop)
"r" = (/obj/structure/pilruin/light,/turf/simulated/floor/tiled/techfloor/grid,/area/template_noop)
"s" = (/obj/structure/pilruin/light,/mob/living/simple_animal/hostile/retaliate/malf_drone{hostile_drone = -1},/turf/simulated/floor/tiled/techfloor,/area/template_noop)
"t" = (/obj/effect/catwalk_plated,/turf/simulated/floor/exoplanet/concrete,/area/template_noop)

(1,1,1) = {"
jaabaaaaabaaa
accccccccccca
accdddddddcca
ecdrfcgcfrdch
acdfiiiiifdca
acdiiiiiiidca
acdciisiicdca
acdiiiiiiidca
acdfiiiiifdca
ecdrfcccfrdch
accddklkddcca
accccciccccca
aaamncocpmaaa
aaammqtqmmaaa
aaaamtttmaaaa
"}
