"a" = (/turf/simulated/floor/exoplanet/water/shallow/tar,/area/template_noop)
"b" = (/turf/template_noop,/area/template_noop)
"c" = (/obj/structure/flora/ausbushes/lavendergrass,/turf/template_noop,/area/template_noop)
"d" = (/obj/machinery/artifact,/turf/simulated/floor/exoplanet/shrouded,/area/template_noop)
"e" = (/obj/structure/flora/ausbushes/fullgrass,/turf/template_noop,/area/template_noop)
"f" = (/obj/structure/monolith,/turf/simulated/floor/exoplanet/water/shallow/tar,/area/template_noop)

(1,1,1) = {"
abbbcaaabbb
bbbaafaaaba
bcaaaaaaacb
baaaaaaaaab
baaaaaaaaab
bfaaadaaafa
aaaaaaaaaab
aaaaaaaaaab
aaaaaaaaabb
eaaaafaacab
bbaabbcbbbb
"}
